
NO ./textures/stone.png
SO ./textures/error.png
WE ./textures/error.png
EA ./textures/error.png

F 79,32,15
C 4,3,72

111111111
100000001
10S000101
100000001
100000001
100000001
100000001
100000001
100000001
100000001
111111111