
NO ./error.png
SO ./error.png
WE ./error.png
EA ./error.png

F 120,100,160
C 225,30,255

11111
10001
10W01
10001
11111