
NO ./error.png
SO ./error.png
WE ./error.png
EA ./error.png

F 120,100,160
C 225,30,255

111111111
100000001
10W000001
100000001
100000001
100000001
100000001
100000001
100000001
100000001
111111111