NO ./textures/ice.png
SO ./textures/stone.png
WE ./textures/stone.png
EA ./textures/ice.png

F 134,214,216
C 185,232,234

11111111111
10000000001
100000000011111
100000000000001
100000000000001
100000000000001
100000000000001
100000000000001
111000000000001
   100000000001
111100000000001
100100000000001
100110000000001
1001011110000N1
1111111  111111