NO ./textures/oak.png
SO ./textures/oak.png
WE ./textures/oak.png
EA ./textures/oak.png

F 0,0,2
C 0,0,1

11111111111111111111111111111111111111111111111111
10000000100010001000000010000000000000000000000011
11111110101010101011111010111111111111111111111011
10000000101000101010100010001000100000001000000011
10111111101111101010101111101011101111101011111011
10100000101000100010001000001010001000101010001011
10111010101110111110111111101010111010101010101011
10001010001000000010000000101010001010001000101011
11101011111011101111111110101011101011111111101011
10001010100010001000000000100010001000000000101011
10111010101011101011111111111010111111111110101011
10001010001000101010000010001010000010000010001011
11101010111110101010111010101110111010111111111011
10001010000010101000101000100010100010001000001011
10111011101110101111101111111010101111101011101011
10100010101000100000001000001010101000100010001011
10111010101011111011111010111010101010111010111011
1000001010100010001E000010000010101010001010000011
11111110101110111110111111111110101011101011111111
10000000101010100000100000000010100010001000000011
10111111101010101111101111111011101011111110111111
10000000100010000000001000100000101000000000100011
10111111111110111111111011111110101111111110111011
10000000000000100000100010001000101000001010000011
10111111111110111110111110101011111111111010111111
10100000000010000010001010100010000000000010000011
10101111101111111110101110111110111111111110111111
10101000100000000010100000100000100000100000100011
10101111111111111111111111111010111110101111111011
10000000000010000000001000000010100010101000000011
11111110111011111111101111111010111111101110111111
10000010100000100000101000001000100010001010100011
10111110111110101111101011111110111110111010111111
10000000001000100000001010000010000010101010100011
11111111101110101111101011111011111110101010111111
10000000100000101000000010000010000000101010100011
10111111111110111110111110111110111111101010111111
10001000100010000010001010000010000000001010000011
10111110111110111110101011111111111111111010111111
10100010001010001000101010000000000000001010000011
10111110101110111111101111111111101111111010111111
10100000100010100000101000001000101000001010000011
10111111111010101111111110111010101011111010111111
10000000000010001000000010000000101000100010000011
10111111111110111110111110111110101110111110111111
10000000000000100000100010000000100000100000100001
11111111111111111111111111111111111111111111111111