NO ./textures/dirt.png
SO ./textures/dirt.png
WE ./textures/dirt.png

F 128,128,128
C 79,32,15

111111111
1E0100001
100000101
111100101
100000001
100110011
100100111
100110011
100010001
101000001
111111111